NO ./textures/N.xpm
SO ./textures/S.xpm
WE ./textures/W.xpm
EA ./textures/E.xpm

F 20,10, 150
C 115,130,10

11111111
10000001
11000001
100E0001
100000111111
11111111
